first_name	last_name	email	password
Margarethe	Neilson	mneilson0@tinyurl.com	aLSHBk0kek
Tildie	Ord	tord1@google.com.au	JdJfHA
Gayla	Snedker	gsnedker2@about.me	cG5plzcOZb5
Mireielle	Vitler	mvitler3@go.com	6pOeZvsYW0
Ettie	Spenley	espenley4@economist.com	QThhkC1ul0V
Rubin	Graddell	rgraddell5@1688.com	it4zTd7BN
Patricio	Chastey	pchastey6@gmpg.org	t79vrkokZ8jE
Brewster	Surr	bsurr7@umich.edu	38kigQ0UI
Rafaelia	Snelgar	rsnelgar8@npr.org	wox53UY
Nicola	Petrollo	npetrollo9@rakuten.co.jp	JHk0zodX7
Everard	Stichall	estichalla@nature.com	ILm8fLVQUG
Sibylla	Llewellen	sllewellenb@pen.io	3DthlrXPhBt
Malina	Whitewood	mwhitewoodc@tamu.edu	oPnlpLPUIe
Hestia	Lovell	hlovelld@bloomberg.com	LIVzLxj
Gladys	Castane	gcastanee@xing.com	KV5dRUnk8Dw
Jessee	Arnaldy	jarnaldyf@upenn.edu	OzTntOqruaY
Anette	Marcone	amarconeg@com.com	NnDjtQfywJu
Bonny	Dowears	bdowearsh@pbs.org	KJzu4fqUvK
Ruthann	Walby	rwalbyi@census.gov	by0cexpANBWh
Belinda	Peplaw	bpeplawj@statcounter.com	ZMxAxj1M
